000000000000
000000000000
000000000000
000000000000
000311111000
000010021000
000010011000
000011111000
000010010000
000010010000
000011111140
000000000000